###############
#S #  #       #
# ### # #######
#         #   #
# #  ###  # # #
# ## #    ### #
#    # ##   F #
###############